старорежимность
австралопитек
покраснение
равновесие
полковник
стационар
кильватер
спаниель
внимание

Вениамин
апельсин
вертикаль
соратница
нерасторжимость
ватерполистка
пенсионерка
своенравие
клоповник

арфа - фара
гура - рагу
ремонт - монтер - ментор
собор - оброс
строка - кастор - костра - сократ - торакс
булка - кабул
бука - куба - баку
баул - блуа - луба
пробирка - приборка
кобра - бакор - барок
истом - сомит
пост - стоп
амбар - брама
мазур - мурза
румба - умбра
разум - мазур - замру - мурза
мура - амур - муар
азур - разу - аруз
муза - узам
макитра - картами
карта - карат - катар
ирак - кира - икар
киев - веки
осетр - остер
сорт - торс - трос - рост - сорт
ситро - истор - сирот - сорит - сотри
просто - стопор
стропа - пастор
стек - текс
фата - тафа
домино - моноид
мирон - минор
стол - слот
дельта - делать - деталь
кафель - кефаль